EEEEEEEEEE
EEEEEEEEEE
EEEEEAAEEE
EEEEEEAAEE
EEEEEAAAAE
EEEEEEAAEE
EEEEEAAEEE
EEEEEEEEEE
EEEEEEEEEE
EEEEEEEEEE

